AAAAAATACTATTA -> AAAAATACTATTAT
AAAAATACTATTAT -> AAAATACTATTATA
AAAATACTATTATA -> AAATACTATTATAG
AAATACCTTCCTTA -> AATACCTTCCTTAA
AAATACTATTATAG -> AATACTATTATAGT
AAATTATATTCAAT -> AATTATATTCAATC
AACAATATTATTAA -> ACAATATTATTAAG
AACATAGTTAAATA -> ACATAGTTAAATAC
AAGGTATTTAAAAA -> AGGTATTTAAAAAA
AATACATATATAAT -> ATACATATATAATA
AATACCTTCCTTAA -> ATACCTTCCTTAAT
AATACTATTATAGT -> ATACTATTATAGTA
AATACTGTTAAATT -> ATACTGTTAAATTA
AATACTTTTAACAA -> ATACTTTTAACAAT
AATATTATTAAGGT -> ATATTATTAAGGTA
AATCAATACATATA -> ATCAATACATATAT
AATTATATTCAATC -> ATTATATTCAATCA
ACAATATTATTAAG -> CAATATTATTAAGG
ACATAGTTAAATAC -> CATAGTTAAATACC
ACATATATAATATT -> CATATATAATATTA
ACCTTCCTTAATAC -> CCTTCCTTAATACT
ACTATTATAGTATT -> CTATTATAGTATTT
ACTGTTAAATTATA -> CTGTTAAATTATAT
ACTTTTAACAATAT -> CTTTTAACAATATT
AGGTATTTAAAAAA -> GGTATTTAAAAAAT
AGTATTTAACATAG -> GTATTTAACATAGT
AGTTAAATACCTTC -> GTTAAATACCTTCC
AGTTAATACTTTTA -> GTTAATACTTTTAA
AGTTATTATTTAGT -> GTTATTATTTAGTT
ATAATATTATTAAA -> TAATATTATTAAAA
ATACATATATAATA -> TACATATATAATAT
ATACCTTCCTTAAT -> TACCTTCCTTAATA
ATACTATTATAGTA -> TACTATTATAGTAT
ATACTGTTAAATTA -> TACTGTTAAATTAT
ATACTTTTAACAAT -> TACTTTTAACAATA
ATAGTATTTAACAT -> TAGTATTTAACATA
ATAGTTAAATACCT -> TAGTTAAATACCTT
ATATAATATTATTA -> TATAATATTATTAA
ATATATAATATTAT -> TATATAATATTATT
ATATTATTAAGGTA -> TATTATTAAGGTAT
ATATTCAATCAATA -> TATTCAATCAATAC
ATCAATACATATAT -> TCAATACATATATA
ATTAAGGTATTTAA -> TTAAGGTATTTAAA
ATTATAGTATTTAA -> TTATAGTATTTAAC
ATTATATTCAATCA -> TTATATTCAATCAA
ATTATTAAGGTATT -> TTATTAAGGTATTT
ATTATTTAGTTAAT -> TTATTTAGTTAATA
ATTCAATCAATACA -> TTCAATCAATACAT
ATTTAAAAAATACT -> TTTAAAAAATACTA
ATTTAACATAGTTA -> TTTAACATAGTTAA
ATTTAGTTAATACT -> TTTAGTTAATACTT
CAATACATATATAA -> AATACATATATAAT
CAATATTATTAAGG -> AATATTATTAAGGT
CAATCAATACATAT -> AATCAATACATATA
CATAGTTAAATACC -> ATAGTTAAATACCT
CATATATAATATTA -> ATATATAATATTAT
CCTTAATACTGTTA -> CTTAATACTGTTAA
CCTTCCTTAATACT -> CTTCCTTAATACTG
CTATTATAGTATTT -> TATTATAGTATTTA
CTGTTAAATTATAT -> TGTTAAATTATATT
CTTAATACTGTTAA -> TTAATACTGTTAAA
CTTCCTTAATACTG -> TTCCTTAATACTGT
CTTTTAACAATATT -> TTTTAACAATATTA
GGTATTTAAAAAAT -> GTATTTAAAAAATA
GTATTTAAAAAATA -> TATTTAAAAAATAC
GTATTTAACATAGT -> TATTTAACATAGTT
GTTAAATACCTTCC -> TTAAATACCTTCCT
GTTAAATTATATTC -> TTAAATTATATTCA
GTTAATACTTTTAA -> TTAATACTTTTAAC
GTTATTATTTAGTT -> TTATTATTTAGTTA
TAAAAAATACTATT -> AAAAAATACTATTA
TAAATACCTTCCTT -> AAATACCTTCCTTA
TAAATTATATTCAA -> AAATTATATTCAAT
TAACAATATTATTA -> AACAATATTATTAA
TAACATAGTTAAAT -> AACATAGTTAAATA
TAAGGTATTTAAAA -> AAGGTATTTAAAAA
TAATACTGTTAAAT -> AATACTGTTAAATT
TAATACTTTTAACA -> AATACTTTTAACAA
TACATATATAATAT -> ACATATATAATATT
TACCTTCCTTAATA -> ACCTTCCTTAATAC
TACTATTATAGTAT -> ACTATTATAGTATT
TACTGTTAAATTAT -> ACTGTTAAATTATA
TACTTTTAACAATA -> ACTTTTAACAATAT
TAGTATTTAACATA -> AGTATTTAACATAG
TAGTTAAATACCTT -> AGTTAAATACCTTC
TAGTTAATACTTTT -> AGTTAATACTTTTA
TATAATATTATTAA -> ATAATATTATTAAA
TATAGTATTTAACA -> ATAGTATTTAACAT
TATATAATATTATT -> ATATAATATTATTA
TATATTCAATCAAT -> ATATTCAATCAATA
TATTAAGGTATTTA -> ATTAAGGTATTTAA
TATTATAGTATTTA -> ATTATAGTATTTAA
TATTATTAAGGTAT -> ATTATTAAGGTATT
TATTATTTAGTTAA -> ATTATTTAGTTAAT
TATTCAATCAATAC -> ATTCAATCAATACA
TATTTAAAAAATAC -> ATTTAAAAAATACT
TATTTAACATAGTT -> ATTTAACATAGTTA
TATTTAGTTAATAC -> ATTTAGTTAATACT
TCAATACATATATA -> CAATACATATATAA
TCAATCAATACATA -> CAATCAATACATAT
TCCTTAATACTGTT -> CCTTAATACTGTTA
TGTTAAATTATATT -> GTTAAATTATATTC
TTAAAAAATACTAT -> TAAAAAATACTATT
TTAAATACCTTCCT -> TAAATACCTTCCTT
TTAAATTATATTCA -> TAAATTATATTCAA
TTAACAATATTATT -> TAACAATATTATTA
TTAACATAGTTAAA -> TAACATAGTTAAAT
TTAAGGTATTTAAA -> TAAGGTATTTAAAA
TTAATACTGTTAAA -> TAATACTGTTAAAT
TTAATACTTTTAAC -> TAATACTTTTAACA
TTAGTTAATACTTT -> TAGTTAATACTTTT
TTATAGTATTTAAC -> TATAGTATTTAACA
TTATATTCAATCAA -> TATATTCAATCAAT
TTATTAAGGTATTT -> TATTAAGGTATTTA
TTATTATTTAGTTA -> TATTATTTAGTTAA
TTATTTAGTTAATA -> TATTTAGTTAATAC
TTCAATCAATACAT -> TCAATCAATACATA
TTCCTTAATACTGT -> TCCTTAATACTGTT
TTTAAAAAATACTA -> TTAAAAAATACTAT
TTTAACAATATTAT -> TTAACAATATTATT
TTTAACATAGTTAA -> TTAACATAGTTAAA
TTTAGTTAATACTT -> TTAGTTAATACTTT
TTTTAACAATATTA -> TTTAACAATATTAT
